{
	"numTilesX":13,
	"numTilesY":10,
	"size":[64,64],
	"start":[32,32],
	"tileNames":["","tile01","tile02","tile03","tile04","tile05","tile06"],
	"tiles":[
			0,0,0,0,0,1,1,1,1,1,1,1,1,
			0,0,0,0,0,0,0,0,0,0,0,0,0,
			0,0,0,0,0,0,0,0,0,0,0,6,6,
			0,0,0,0,0,0,0,0,0,0,6,6,6,
			0,0,0,0,0,0,0,0,0,6,6,6,6,
			3,0,0,0,0,0,0,0,6,5,5,5,5,
			3,3,0,0,0,0,0,0,0,5,5,5,5,
			3,3,3,0,0,0,0,0,0,5,5,5,5,
			2,2,2,2,2,2,2,2,2,2,2,2,2,
			4,4,4,4,4,4,4,4,4,4,4,4,4
			]
}